NO	./textures/backroom.xpm
SO	./textures/backroom.xpm
EA	./textures/backroom.xpm
WE	./textures/backroom.xpm

F	130, 87, 7
C	204, 157, 4

111                1111              11111111111111111111111
1S1                1001              10000000000000000000001
1011111      1111111001111111        100000000000000000000011111111111111111111
1000001      1000000000000001        100000000000000000000010000000000000000001
1001001      1000000000000001        11100000101111111111111011111111111111110111111111111111111
1001001      1001111001111001        10000000000000000000000000000000000000000000000000000000001
1001001      1001  1001  1001        10111111111111111111101111111111101111111111101111111111101
1001001111   1001  1001  1001        101                 101         101         101000000000001
1001000001   1001  1001  1001        101                1101         101         101011111111111
1001000001   1001  1001  1001        101                1001  1111111101         101000000000001
1001111001   1001  1001  1001        101                1011  1000000001         101111111111101
1001111001   1001  1001  1001        101                1001  101111111          101         101
1001 100001  1001  1001  1001        101               11101  101     11111111111101111111111101
1001 101101111001  1001  1001        101               10001  1011111110000000000000000000000101
1001 101100000001  1111  1001        101       1111111110111  1000000010000000000000000000000101
1001 101111111111        1001        101       10000000001    1111111110000000000000000000000101
1001 101                 1001        111       10111111111            10000000000000000000000101
1001 101                 1001                  111                    10000000000000000000000101
10011111111111111111111111001                 11011111111111111111111110000000000000000000000101
10000000000000000000000000001                 10000000000000000000000000000000000000000000000101
10001000000000000000000100001                 11011111111111111111111110000000000000000000000101
10011100000001100000001110001                  111                    10000000000000000000000101
100010000000000000000001000011111111111111111111111111111111111111111110000000000000000000000101
100000000000000000000000000000001000100010001000100010001000100010001000000000000000000000000101
100000000000000000000000000000100010001000100010001000100010001000100010000000000000000000000101
1000100000000000000000010000111111111111111111111111111111111111111111100000000000000000000001011111111
10011100000001100000001110001                                         100000000000000000000001000000001
10001000000000000000000100001                                         100000000000000000000001111111111
10000000000000000000000000001                                         100000000000000000000001
11111111111111111111111111111                                         100000000000000000000001
                                                                      100000000000000000000001
                                                                      100000000000000000000001
                                                                      100000000000000000000001
                                                                      100000000000000000000001
                                                                      100000000000000000000001
                                                                      111111111111111111111111
