1111111111
100000011
1001N00001
1111111111