111111111111111111111111111111111111111111111111111111111111
100100000000000000000000000000000000000000000000000000000001
1P0001111100000000000001111100000000000000000000000000000001
1000110010000000000000000001C0000000000000000000000000100001
1001C1000000000010000000000100000000000000000000000000110001
100101000000000010000000000000000000000000000000000010100001
10010100000001111000000000000000000000010000000000001C100001
100101000000000000000000000000000000000000000000000010100001
100101000000000000011000000000000000000000000000000010000001
10010100000000000001E000000000000000000111110000000010000001
1001010000011000000100000C0000000000000111110000000000000001
10010100000000C100000000000000000000000000000000000000000001
100001000000001100000000000000000000000000000000000000000001
100001000000000100000000000000000000000000000000000000000001
100001000000000000000000000010000000000000000000000000000001
100001000000000000000111111110000000000000000000000000000001
100001000000000000000111111110000000000000000000000000000001
1000010000000000000000000000C0000000000000000000000000000001
100001000000000000000000000000000000000000000000000000000001
100001000000000000000000000000000000000000000000000000000001
1000010000000000000000000000C0000000000000000000000000000001
100001000000000000000000000000000000000000000000000000000001
100001000000000000000000000000000000000000000000000000000001
1000010000000000000000000000C0000000000000000000000000000001
100001000000000000000000000000000000000000000000000000000001
1000010000000000000000000000C0000000000000000000000000000001
1000010000000000000000C01111110000001111111111111111111111C1
1000010000000000000000000001111C0000000000000000000000000001
1000010000000000000000000001C0000000000000000000000000000001
1000010000000000000000C01111110000001111111111111111111111C1
1000010000000000000000000001111C0000000000000000000000000001
1000010000000000000000000001C0000000000000000000000000000001
111111111111111111111111111111111111111111111111111111111111
