1111111111111
100100C000011
10000111101C1


1P0011E000011
1111111111111
