1111111111111111111111111111
1P00011111000000000001111101
10001100100000000000000001C1
1001C10000000000100000E00101
1001010000000000100000000001
1001010000000111100000000001
1001010000000000000E00000001
1111111111111111111111111111
