1111111111111111
10C10000000C0001
1000011111001001
1000110C00001001
100P010100001001
10000001000000E1
1111111111111111
