
NO	./Textures/backroom.xpm

F	130, 87, 7
SO	./Textures/cyan_concrete.xpm
C	204, 157, 4

WE	./Textures/backroom.xpm


EA	./Textures/backroom.xpm



11111111111111111111111
11100000000000000111111
11100000000000000111111
111000000S0000111111111
11100000000000000111111
11111111111111111111111
