1111111111111111
10010000000C0001
1P00011111000001
100011C100010E01
10100000001C0001
1111111111111111
